gog - GOG
steam - Steam
psn - Playstation Network
xboxone - XBoxOne
generic - Generic
origin - Origin
uplay - Ubisoft Uplay/Connect
battlenet - Battle.net
epic - Epic
bethesda - Bethesda
paradox - Paradox Plaza
humble - Humble Bundle
kartridge - Kartridge
itch - Itch.io
nswitch - Nintendo Switch
nwiiu - Nintendo Wii U
nwii - Nintendo Wii
ncube - Nintendo GameCube
riot - Riot Games
wargaming - Wargaming
ngameboy - Nintendo GameBoy
atari - Atari
amiga - Amiga
snes - Super Nintendo Entertainment System
beamdog - Beamdog
d2d - Direct2Drive
discord - Discord
dotemu - DotEmu
gamehouse - GameHouse
gmg - GreenManGaming
weplay - WePlay
zx - ZxSpectrum
vision - ColecoVision
nes - Nintendo Entertainment System
sms - Sega Master System
c64 - Commodore 64
pce - PC Engine
segag - Sega Genesis
neo - NeoGeo
sega32 - Sega 32X
segacd - Sega CD
3do - 3Do
saturn - Sega Saturn
psx - PlayStation
ps2 - PlayStation 2
n64 - Nintendo 64
jaguar - Atari Jaguar
dc - Sega Dreamcast
xboxog - Original Xbox
amazon - Amazon
gg - GamersGate
egg - Newegg
bb - BestBuy
gameuk - GameUk
fanatical - Fanatical
playasia - PlayAsia
stadia - Stadia
arc - Arc
eso - Elder Scrolls Online
glyph - Glyph
aionl - Aion Legions Of War
aion - Aion
blade - Blade And Soul
gw - Guild Wars
gw2 - Guild Wars 2
lin2 - Lineage 2
ffxi - FinalFantasy 11
ffxiv - FinalFantasy 14
totalwar - Total War
winstore - Microsoft Store
elites - Elite Dangerous
star - Star Citizen
psp - Sony PSP
psvita - PlayStation Vita
nds - Nintendo DS
3ds - Nintendo 3DS
pathofexile - Path Of Exile
twitch - Twitch
minecraft - Minecraft
gamesessions - GameSessions
nuuvem - Nuuvem
fxstore - FXStore
indiegala - IndieGala
playfire - Playfire
oculus - Oculus
test - Test
rockstar - Rockstar
